+--+--+--+--+--+--+--+--+--+--+--+--+--+--+--+--+--+--+--+--+--+--+--+--+--+
   |     |     |     |        |              |        |     |     |        |
+  +  +  +  +  +  +  +--+  +  +--+--+  +--+  +  +--+  +--+  +  +  +  +--+  +
|  |  |  |  |     |     |  |        |     |  |  |           |  |  |     |  |
+  +  +--+  +--+--+--+  +  +  +--+  +--+  +  +--+  +  +--+--+--+  +--+  +  +
|  |        |  |           |     |     |  |     |  |     |     |  |  |  |  |
+  +--+--+--+  +  +--+--+--+--+  +--+  +  +--+  +  +--+  +  +  +  +  +  +  +
|     |        |           |  |     |     |  |     |        |  |  |     |  |
+  +  +  +  +--+--+--+--+  +  +  +--+--+--+  +--+--+--+--+--+  +  +  +  +  +
|  |  |  |                 |     |     |     |     |     |        |  |  |  |
+  +--+  +  +--+--+--+--+--+  +--+  +--+  +--+  +--+  +  +  +  +--+--+  +  +
|        |  |                 |        |  |  |        |     |     |     |  |
+--+--+--+  +  +--+--+  +--+--+--+  +  +  +  +--+--+--+--+--+--+  +  +--+  +
|  |     |  |        |              |  |  |              |     |  |  |     |
+  +  +  +  +  +--+  +--+--+  +--+--+  +  +--+--+--+--+  +  +--+  +  +  +--+
|     |     |     |     |     |  |     |  |        |     |        |  |  |  |
+--+--+--+--+--+  +--+  +  +--+  +--+--+  +--+  +--+  +--+  +--+  +  +  +  +
|     |        |  |     |     |  |     |     |     |        |     |  |  |  |
+  +  +  +--+  +--+  +--+--+  +  +  +  +--+  +  +  +--+--+--+  +--+  +  +  +
|  |  |  |        |        |  |     |        |  |        |  |        |     |
+  +--+  +  +--+  +--+--+  +--+--+--+--+--+--+--+--+--+  +  +--+--+--+--+--+
|        |     |        |        |     |              |     |           |  |
+--+--+--+--+  +  +--+--+--+--+  +  +  +  +--+--+--+  +  +  +  +--+--+  +  +
|              |  |              |  |     |        |  |  |     |           |
+  +--+--+--+--+  +  +--+--+--+--+  +--+--+--+  +--+  +  +--+--+  +--+  +--+
|     |        |     |     |     |     |     |        |     |  |  |  |  |  |
+--+  +  +--+  +--+--+  +  +  +  +  +--+  +  +--+--+--+--+  +  +  +  +  +  +
|     |  |  |     |     |  |  |  |  |     |  |        |     |     |        |
+  +--+  +  +  +--+  +  +  +  +  +--+  +--+  +--+--+  +  +--+--+--+--+--+  +
|  |     |     |     |  |     |  |     |  |        |  |     |     |        |
+  +  +--+  +--+  +--+  +--+--+  +  +--+  +--+--+--+  +--+  +  +  +  +--+--+
|  |     |     |  |     |        |        |        |        |  |  |  |     |
+  +--+  +  +  +  +  +--+  +--+  +--+--+  +--+--+  +--+--+--+  +--+  +  +  +
|     |  |  |  |  |  |     |  |     |  |     |     |                 |  |  |
+--+  +--+  +  +--+  +--+--+  +--+  +  +--+  +  +--+  +--+--+  +--+--+  +  +
|           |     |        |        |     |     |     |        |        |  |
+  +--+--+--+  +  +--+  +  +--+--+  +--+  +--+--+  +--+  +--+--+--+--+--+  +
|  |           |     |  |        |        |        |        |              |
+--+  +--+--+--+  +--+  +--+--+  +--+--+--+  +--+--+--+  +  +  +  +  +--+--+
|     |     |  |        |  |     |           |     |     |  |  |  |  |     |
+  +--+--+  +  +--+--+  +  +  +--+--+  +--+--+  +--+  +  +  +--+  +  +--+  +
|        |  |           |     |     |  |     |        |  |  |     |     |  |
+  +--+  +  +--+--+--+--+--+--+  +  +  +--+  +--+--+--+  +  +  +--+--+  +  +
|     |  |  |              |     |  |     |  |           |  |  |     |     |
+--+  +  +  +  +--+--+--+  +  +--+  +--+  +  +--+--+--+--+  +  +  +  +--+--+
|     |  |  |     |     |     |     |     |                 |  |  |     |  |
+  +--+  +  +  +  +--+  +--+--+--+--+  +  +--+--+--+--+--+  +  +--+--+  +  +
|     |  |  |  |  |                    |     |        |     |        |  |  |
+--+  +  +  +  +  +  +--+--+--+--+--+--+--+  +--+--+  +  +--+  +--+  +  +--+
|     |     |  |     |                                |        |           |
+--+--+--+--+--+--+--+--+--+--+--+--+--+--+--+--+--+--+--+--+--+--+--+--+--+