+--+--+--+--+--+--+--+--+--+--+--+--+--+--+--+--+--+--+--+--+--+--+--+--+--+--+--+--+--+--+--+--+--+--+--+--+--+--+--+--+
         |        |        |        |                 |              |        |        |     |     |     |     |     |  |
         |        |        |        |                 |              |        |        |     |     |     |     |     |  |
+  +--+  +  +--+  +  +--+  +--+--+  +  +--+--+--+--+  +  +  +--+--+  +  +--+  +  +--+  +  +  +--+  +  +  +  +  +  +  +  +
|     |     |  |     |     |        |  |     |     |  |  |        |  |  |     |  |        |           |     |     |  |  |
|     |     |  |     |     |        |  |     |     |  |  |        |  |  |     |  |        |           |     |     |  |  |
+--+  +--+--+  +--+  +  +--+  +--+--+--+  +  +  +--+  +  +--+--+--+  +  +  +--+  +  +  +--+--+--+--+--+--+--+--+--+  +  +
|     |     |  |     |     |  |           |        |     |     |     |  |        |  |  |              |                 |
|     |     |  |     |     |  |           |        |     |     |     |  |        |  |  |              |                 |
+  +--+  +  +  +  +--+--+  +  +--+--+--+--+--+--+  +--+--+  +  +  +--+  +--+--+--+  +  +--+--+--+--+  +--+--+--+--+--+--+
|        |  |        |  |     |        |     |     |     |  |  |  |        |        |  |        |                    |  |
|        |  |        |  |     |        |     |     |     |  |  |  |        |        |  |        |                    |  |
+--+--+--+  +--+--+  +  +--+--+  +  +  +  +  +  +--+  +  +  +  +  +  +--+  +  +--+--+--+  +  +--+  +--+--+--+--+--+  +  +
|     |  |  |     |     |        |  |     |  |  |     |  |  |     |  |     |     |        |     |  |     |        |     |
|     |  |  |     |     |        |  |     |  |  |     |  |  |     |  |     |     |        |     |  |     |        |     |
+  +  +  +  +--+  +--+  +  +--+--+--+--+--+  +  +  +--+--+  +--+--+  +  +--+--+  +  +--+--+--+  +  +  +  +  +  +--+--+  +
|  |     |     |     |     |     |           |  |  |  |     |  |     |  |     |     |     |     |     |  |  |  |        |
|  |     |     |     |     |     |           |  |  |  |     |  |     |  |     |     |     |     |     |  |  |  |        |
+  +--+--+--+  +--+  +--+--+  +--+  +--+--+--+  +  +  +  +--+  +  +--+  +  +  +--+--+  +  +  +--+--+--+  +--+  +  +--+--+
|  |  |     |     |  |     |  |                 |  |  |  |     |  |  |     |  |     |  |  |  |           |     |        |
|  |  |     |     |  |     |  |                 |  |  |  |     |  |  |     |  |     |  |  |  |           |     |        |
+  +  +  +  +--+  +  +  +  +  +  +  +--+--+  +--+  +  +  +  +--+  +  +--+--+  +  +--+  +  +  +  +--+--+--+  +--+--+--+  +
|        |        |  |  |  |     |        |  |     |  |  |        |           |     |  |     |              |     |     |
|        |        |  |  |  |     |        |  |     |  |  |        |           |     |  |     |              |     |     |
+--+--+--+--+--+  +  +  +  +--+  +--+--+  +  +  +--+  +  +  +--+--+--+  +--+--+--+  +  +--+--+--+--+--+--+--+  +  +  +--+
|        |     |     |  |        |        |     |     |        |     |           |     |        |           |  |  |     |
|        |     |     |  |        |        |     |     |        |     |           |     |        |           |  |  |     |
+  +--+  +  +  +--+--+  +--+--+--+  +  +--+  +--+  +--+--+  +  +  +  +--+--+  +--+--+  +  +--+  +  +--+  +--+  +  +--+  +
|  |     |  |           |        |  |     |        |     |  |     |        |  |     |  |     |  |  |  |     |  |  |     |
|  |     |  |           |        |  |     |        |     |  |     |        |  |     |  |     |  |  |  |     |  |  |     |
+--+  +--+  +--+--+--+--+  +--+  +  +--+  +--+--+--+  +--+  +--+--+--+--+  +  +  +  +--+  +--+  +  +  +--+  +  +--+  +  +
|     |     |     |     |     |     |  |                    |        |     |     |     |     |     |        |  |     |  |
|     |     |     |     |     |     |  |                    |        |     |     |     |     |     |        |  |     |  |
+  +--+  +--+  +--+  +  +--+  +--+--+  +--+--+--+--+--+--+--+  +  +--+  +  +  +--+--+  +--+  +--+--+--+--+--+  +  +--+--+
|              |     |     |  |  |              |           |  |        |  |  |        |  |  |     |        |  |  |     |
|              |     |     |  |  |              |           |  |        |  |  |        |  |  |     |        |  |  |     |
+--+--+--+--+--+  +--+--+  +  +  +  +--+--+--+  +  +  +--+--+  +--+--+--+--+  +  +--+--+  +  +  +  +--+  +  +  +  +  +  +
|                 |     |        |        |        |        |  |     |        |        |  |  |  |        |     |  |  |  |
|                 |     |        |        |        |        |  |     |        |        |  |  |  |        |     |  |  |  |
+  +--+--+--+--+--+  +--+--+--+--+--+--+  +--+--+--+--+--+  +  +  +  +  +--+--+--+--+  +  +  +  +--+--+--+  +--+  +  +  +
|     |           |     |        |     |        |           |  |  |  |  |     |        |  |     |  |     |     |  |  |  |
|     |           |     |        |     |        |           |  |  |  |  |     |        |  |     |  |     |     |  |  |  |
+--+  +--+  +--+  +--+  +--+--+  +  +  +--+--+  +  +  +--+--+  +--+  +  +  +--+  +--+--+  +--+--+  +  +  +--+  +  +  +  +
|     |     |           |        |  |  |     |  |  |        |  |     |  |        |                    |     |  |  |  |  |
|     |     |           |        |  |  |     |  |  |        |  |     |  |        |                    |     |  |  |  |  |
+  +--+  +--+  +  +--+--+  +--+--+  +  +  +--+  +  +--+--+--+  +  +--+  +--+  +--+  +--+--+--+--+--+--+--+  +  +  +  +  +
|  |     |     |           |        |  |     |  |  |           |  |  |     |  |     |           |              |  |  |  |
|  |     |     |           |        |  |     |  |  |           |  |  |     |  |     |           |              |  |  |  |
+  +  +--+  +--+  +  +--+--+  +--+--+  +--+  +  +--+      --+--+  +  +--+  +  +  +--+  +--+--+  +  +--+--+  +--+  +  +  +
|     |  |  |     |           |        |     |        |     |     |        |  |  |     |     |     |        |        |  |
|     |  |  |     |           |        |     |        |     |     |        |  |  |     |     |     |        |        |  |
+--+--+  +  +  +--+--+--+--+--+  +--+--+  +--+  +--+  +  +  +        +--+--+  +  +  +  +  +  +--+--+  +  +--+--+  +--+  +
|     |     |     |        |  |  |     |  |  |     |     |  |  |     |     |     |  |     |  |     |  |     |     |     |
|     |     |     |        |  |  |     |  |  |     |     |  |  |     |     |     |  |     |  |     |  |     |     |     |
+  +--+--+--+  +  +  +--+  +  +  +--+  +  +  +--+  +--+--+  +  +--+--+  +  +--+--+  +--+--+  +--+  +  +--+--+  +--+--+  +
|           |  |  |  |  |     |              |     |  |     |     |     |     |     |     |        |           |        |
|           |  |  |  |  |     |              |     |  |     |     |     |     |     |     |        |           |        |
+--+--+--+  +  +--+  +  +--+--+--+--+--+--+--+  +--+  +  +--+--+  +  +--+--+  +--+--+  +  +--+--+  +--+--+--+--+  +--+--+
|        |        |     |        |        |     |     |           |  |     |  |        |     |     |        |     |     |
|        |        |     |        |        |     |     |           |  |     |  |        |     |     |        |     |     |
+  +--+  +--+--+  +--+  +  +--+  +  +--+  +  +--+  +  +--+--+--+--+--+  +  +  +  +--+--+--+  +  +--+  +--+  +  +--+  +--+
|     |  |     |  |     |  |     |     |  |        |  |     |     |     |        |  |        |  |     |     |           |
|     |  |     |  |     |  |     |     |  |        |  |     |     |     |        |  |        |  |     |     |           |
+--+  +--+  +--+  +--+  +  +--+  +--+  +  +--+  +--+--+  +  +  +  +  +--+--+  +--+  +  +--+--+  +  +--+  +--+--+--+--+  +
|  |  |     |           |     |  |     |        |        |  |  |  |  |        |     |     |     |  |  |  |  |        |  |
|  |  |     |           |     |  |     |        |        |  |  |  |  |        |     |     |     |  |  |  |  |        |  |
+  +  +  +--+  +--+--+--+--+  +--+  +--+--+--+--+  +--+--+  +--+  +  +  +  +--+  +--+--+  +  +--+  +  +  +  +  +--+  +  +
|  |  |        |                    |     |     |  |     |     |     |  |  |  |  |        |     |     |  |        |     |
|  |  |        |                    |     |     |  |     |     |     |  |  |  |  |        |     |     |  |        |     |
+  +  +--+--+--+  +--+--+--+  +--+  +  +  +  +  +--+  +  +--+  +--+--+--+  +  +  +  +--+--+--+  +--+--+  +--+--+  +--+--+
|              |        |     |     |  |  |  |        |        |     |     |  |  |  |        |  |     |        |  |     |
|              |        |     |     |  |  |  |        |        |     |     |  |  |  |        |  |     |        |  |     |
+--+  +--+--+  +--+--+  +  +--+--+--+  +  +  +--+--+--+  +--+--+  +  +  +--+  +  +  +  +  +  +--+  +  +--+--+  +  +--+  +
|  |     |  |           |  |        |  |     |     |     |     |  |     |  |        |  |  |        |  |  |     |     |  |
|  |     |  |           |  |        |  |     |     |     |     |  |     |  |        |  |  |        |  |  |     |     |  |
+  +--+  +  +--+--+--+--+  +  +--+  +  +--+--+--+  +  +--+  +  +  +--+--+  +--+  +--+--+  +--+--+--+  +  +  +--+--+  +  +
|  |     |              |     |     |        |     |        |     |     |        |     |  |     |     |     |     |     |
|  |     |              |     |     |        |     |        |     |     |        |     |  |     |     |     |     |     |
+  +  +--+--+  +--+  +  +--+--+  +--+  +  +  +  +--+--+--+--+--+--+  +  +  +--+--+  +  +  +  +--+  +--+  +--+  +  +--+--+
|  |           |     |  |        |     |  |  |  |        |           |  |  |     |  |  |  |  |     |     |     |  |     |
|  |           |     |  |        |     |  |  |  |        |           |  |  |     |  |  |  |  |     |     |     |  |     |
+  +--+--+--+--+  +--+--+  +  +--+--+  +  +  +  +  +--+  +  +--+--+--+  +  +--+  +  +  +  +  +  +--+  +--+  +--+  +  +--+
|           |  |  |  |     |        |  |  |     |     |  |     |     |  |     |     |     |  |     |     |     |  |     |
|           |  |  |  |     |        |  |  |     |     |  |     |     |  |     |     |     |  |     |     |     |  |     |
+--+--+--+  +  +  +  +  +--+--+--+  +  +  +  +--+--+  +  +--+  +  +--+  +--+  +--+  +--+--+  +  +  +  +  +--+--+  +--+  +
|     |  |  |  |  |     |     |     |  |  |  |        |  |     |        |  |              |  |  |  |  |  |  |     |     |
|     |  |  |  |  |     |     |     |  |  |  |        |  |     |        |  |              |  |  |  |  |  |  |     |     |
+  +  +  +  +  +  +  +--+  +  +  +--+--+  +  +  +--+--+  +  +--+--+--+--+  +  +--+  +--+  +  +--+  +--+  +  +  +--+  +--+
|  |  |     |     |  |     |     |     |  |     |     |  |  |     |        |     |  |  |  |     |  |        |  |  |     |
|  |  |     |     |  |     |     |     |  |     |     |  |  |     |        |     |  |  |  |     |  |        |  |  |     |
+  +--+  +--+  +--+  +--+--+--+--+--+  +  +--+--+  +  +  +  +  +  +  +--+--+--+  +  +  +  +--+  +  +  +--+--+  +  +--+  +
|     |        |              |           |        |  |  |  |  |  |     |        |  |  |  |  |  |  |  |     |  |        |
|     |        |              |           |        |  |  |  |  |  |     |        |  |  |  |  |  |  |  |     |  |        |
+--+  +--+--+--+  +  +--+  +--+  +--+  +--+  +--+--+  +  +  +  +  +--+  +--+--+--+  +  +  +  +  +  +  +  +  +  +  +--+  +
|  |              |     |  |     |  |  |     |     |  |        |     |                 |  |  |        |  |  |  |  |  |  |
|  |              |     |  |     |  |  |     |     |  |        |     |                 |  |  |        |  |  |  |  |  |  |
+  +--+--+--+--+--+--+  +  +  +--+  +  +  +--+  +  +  +--+  +--+--+  +--+--+  +--+--+--+  +  +  +  +--+--+  +  +  +  +  +
|           |           |     |  |     |     |  |  |        |        |  |     |        |  |  |  |           |  |     |  |
|           |           |     |  |     |     |  |  |        |        |  |     |        |  |  |  |           |  |     |  |
+--+--+--+  +--+  +--+--+--+--+  +--+--+--+  +--+  +--+--+--+  +--+--+  +  +  +  +  +--+  +  +--+--+  +--+--+  +--+--+  +
|           |     |                       |     |              |     |     |  |  |        |  |     |  |     |        |  |
|           |     |                       |     |              |     |     |  |  |        |  |     |  |     |        |  |
+  +--+--+--+  +--+  +--+  +--+--+--+--+--+--+  +--+--+--+  +--+--+  +--+--+--+  +--+--+--+  +  +  +  +  +--+--+--+  +  +
|              |     |     |  |              |  |        |     |           |     |     |     |  |                    |  |
|              |     |     |  |              |  |        |     |           |     |     |     |  |                    |  |
+--+--+  +--+  +  +--+--+--+  +  +--+--+--+--+  +  +--+  +--+--+  +--+--+  +  +--+  +  +  +--+  +--+  +  +--+--+--+--+  +
|     |  |     |     |     |  |     |           |     |        |        |     |     |  |        |     |  |        |     |
|     |  |     |     |     |  |     |           |     |        |        |     |     |  |        |     |  |        |     |
+  +--+  +--+--+--+  +  +  +  +--+  +  +--+--+--+--+  +--+--+  +--+--+  +--+--+  +--+--+--+--+--+  +--+  +  +--+  +  +--+
|     |        |  |     |        |  |  |        |  |  |  |     |     |     |        |           |  |     |  |     |     |
|     |        |  |     |        |  |  |        |  |  |  |     |     |     |        |           |  |     |  |     |     |
+--+  +--+--+  +  +--+--+--+  +  +  +  +  +--+  +  +  +  +  +--+  +--+--+  +  +--+  +  +--+--+  +  +  +  +  +  +--+  +  +
|  |     |  |  |  |     |     |  |  |  |     |     |  |  |  |              |  |     |     |        |  |     |        |  |
|  |     |  |  |  |     |     |  |  |  |     |     |  |  |  |              |  |     |     |        |  |     |        |  |
+  +--+  +  +  +  +--+  +  +--+  +  +  +--+  +--+  +  +  +  +  +--+--+  +--+--+  +--+--+  +--+--+--+--+--+  +--+--+--+  +
|                 |     |     |  |  |  |     |     |     |  |     |     |     |     |     |           |     |     |     |
|                 |     |     |  |  |  |     |     |     |  |     |     |     |     |     |           |     |     |     |
+--+--+  +--+--+--+  +--+--+--+  +  +  +  +--+--+--+--+  +  +--+--+  +--+  +  +--+  +  +--+  +--+--+  +  +--+--+  +  +--+
|                                |     |                 |                 |        |        |        |           |      
|                                |     |                 |                 |        |        |        |           |      
+--+--+--+--+--+--+--+--+--+--+--+--+--+--+--+--+--+--+--+--+--+--+--+--+--+--+--+--+--+--+--+--+--+--+--+--+--+--+--+--+