+---+---+---+---+---+---+---+---+---+---+---+---+---+---+---+---+---+---+---+---+---+---+---+---+---+---+
                |       |       |               |       |               |                       |       |
                |       |       |               |       |               |                       |       |
                |       |       |               |       |               |                       |       |
+   +---+---+   +   +   +   +   +   +---+---+   +   +   +   +---+---+   +   +---+---+---+---+   +   +   +
|       |       |   |   |   |       |       |       |       |               |                   |   |   |
|       |       |   |   |   |       |       |       |       |               |                   |   |   |
|       |       |   |   |   |       |       |       |       |               |                   |   |   |
+---+   +   +---+   +   +   +   +---+   +---+---+---+---+---+   +---+---+   +   +---+---+   +---+---+   +
|       |   |       |       |       |                           |       |   |           |               |
|       |   |       |       |       |                           |       |   |           |               |
|       |   |       |       |       |                           |       |   |           |               |
+   +---+   +   +   +---+---+---+   +---+---+---+   +---+   +---+---+   +   +---+---+   +---+   +---+---+
|       |       |   |           |               |       |   |           |       |   |       |       |   |
|       |       |   |           |               |       |   |           |       |   |       |       |   |
|       |       |   |           |               |       |   |           |       |   |       |       |   |
+   +---+   +---+   +   +---+   +---+---+---+   +   +   +---+   +---+---+   +   +   +---+   +---+   +   +
|   |       |       |       |           |   |   |   |       |   |           |   |           |       |   |
|   |       |       |       |           |   |   |   |       |   |           |   |           |       |   |
|   |       |       |       |           |   |   |   |       |   |           |   |           |       |   |
+---+   +---+   +   +---+   +---+---+   +   +   +---+---+   +   +   +---+---+   +---+---+---+   +---+   +
|       |       |       |           |   |   |   |       |   |           |       |       |   |       |   |
|       |       |       |           |   |   |   |       |   |           |       |       |   |       |   |
|       |       |       |           |   |   |   |       |   |           |       |       |   |       |   |
+   +---+   +---+---+   +---+---+   +   +   +   +   +---+   +---+   +   +   +---+---+   +   +   +   +   +
|       |   |           |       |   |       |   |       |           |   |   |       |   |       |   |   |
|       |   |           |       |   |       |   |       |           |   |   |       |   |       |   |   |
|       |   |           |       |   |       |   |       |           |   |   |       |   |       |   |   |
+---+   +   +   +---+---+   +   +   +---+   +   +---+   +---+   +   +   +   +   +   +   +   +---+   +   +
|   |       |       |       |   |       |   |       |           |   |   |   |   |   |   |   |       |   |
|   |       |       |       |   |       |   |       |           |   |   |   |   |   |   |   |       |   |
|   |       |       |       |   |       |   |       |           |   |   |   |   |   |   |   |       |   |
+   +---+---+---+   +   +   +   +---+---+   +---+   +---+   +---+---+   +   +   +   +   +---+   +---+   +
|               |       |   |           |   |           |           |   |       |   |   |               |
|               |       |   |           |   |           |           |   |       |   |   |               |
|               |       |   |           |   |           |           |   |       |   |   |               |
+---+   +   +---+---+---+---+---+   +   +   +   +---+---+---+---+   +   +---+---+   +   +   +---+---+---+
|       |   |                       |       |   |       |           |   |   |       |   |   |           |
|       |   |                       |       |   |       |           |   |   |       |   |   |           |
|       |   |                       |       |   |       |           |   |   |       |   |   |           |
+   +---+---+   +---+---+---+---+---+---+   +   +   +   +   +---+---+   +   +   +---+   +   +   +---+   +
|   |           |       |                           |   |   |       |   |               |   |   |   |   |
|   |           |       |                           |   |   |       |   |               |   |   |   |   |
|   |           |       |                           |   |   |       |   |               |   |   |   |   |
+   +   +---+---+   +---+   +---+---+   +   +---+---+   +   +   +   +   +   +   +---+---+   +   +   +   +
|       |               |       |       |   |   |       |       |   |   |   |   |   |               |   |
|       |               |       |       |   |   |       |       |   |   |   |   |   |               |   |
|       |               |       |       |   |   |       |       |   |   |   |   |   |               |   |
+   +---+   +---+   +   +---+   +---+---+   +   +   +   +   +---+   +   +---+   +   +   +---+---+---+   +
|   |           |   |                       |       |       |       |       |       |   |       |       |
|   |           |   |                       |       |       |       |       |       |   |       |       |
|   |           |   |                       |       |       |       |       |       |   |       |       |
+   +   +---+   +   +---+---+   +---+---+---+---+   +---+---+   +---+---+   +---+   +   +   +   +   +   +
|   |       |   |           |           |       |           |       |       |   |       |   |   |   |   |
|   |       |   |           |           |       |           |       |       |   |       |   |   |   |   |
|   |       |   |           |           |       |           |       |       |   |       |   |   |   |   |
+   +---+   +   +---+---+---+---+   +---+   +   +---+   +---+---+---+   +---+   +---+   +   +---+   +   +
|           |   |       |       |       |   |   |   |               |       |   |       |       |   |   |
|           |   |       |       |       |   |   |   |               |       |   |       |       |   |   |
|           |   |       |       |       |   |   |   |               |       |   |       |       |   |   |
+---+   +---+   +   +   +   +---+---+   +   +   +   +---+---+   +   +   +   +   +   +   +---+   +   +   +
|       |   |   |   |       |               |               |   |   |       |       |       |       |   |
|       |   |   |   |       |               |               |   |   |       |       |       |       |   |
|       |   |   |   |       |               |               |   |   |       |       |       |       |   |
+   +   +   +   +   +   +---+   +---+   +---+   +---+---+   +   +   +   +   +---+---+---+   +---+---+   +
|   |           |   |       |       |       |       |       |   |       |   |           |   |       |   |
|   |           |   |       |       |       |       |       |   |       |   |           |   |       |   |
|   |           |   |       |       |       |       |       |   |       |   |           |   |       |   |
+   +   +---+---+   +   +---+---+   +   +   +   +   +   +   +---+---+---+   +   +   +---+   +---+   +   +
|   |   |       |   |                   |   |   |   |   |           |       |   |   |       |       |   |
|   |   |       |   |                   |   |   |   |   |           |       |   |   |       |       |   |
|   |   |       |   |                   |   |   |   |   |           |       |   |   |       |       |   |
+   +---+   +   +   +---+---+---+   +   +   +   +   +   +   +---+   +   +---+   +---+   +---+   +---+   +
|       |   |   |       |           |   |       |   |   |   |       |       |               |   |   |   |
|       |   |   |       |           |   |       |   |   |   |       |       |               |   |   |   |
|       |   |   |       |           |   |       |   |   |   |       |       |               |   |   |   |
+---+   +   +   +---+   +   +---+---+   +---+---+   +   +---+   +---+   +   +---+---+   +   +   +   +   +
|   |           |       |   |       |       |       |   |       |       |   |   |       |       |   |   |
|   |           |       |   |       |       |       |   |       |       |   |   |       |       |   |   |
|   |           |       |   |       |       |       |   |       |       |   |   |       |       |   |   |
+   +---+---+   +---+---+   +   +---+---+   +   +---+   +   +---+   +   +   +   +   +---+---+   +   +   +
|           |   |                       |       |       |       |   |   |   |               |           |
|           |   |                       |       |       |       |   |   |   |               |           |
|           |   |                       |       |       |       |   |   |   |               |           |
+---+---+   +   +   +---+---+---+   +---+---+   +   +   +   +   +   +   +   +---+   +---+---+   +---+---+
|       |   |                       |               |   |   |       |   |           |           |       |
|       |   |                       |               |   |   |       |   |           |           |       |
|       |   |                       |               |   |   |       |   |           |           |       |
+   +   +   +---+---+---+   +---+---+   +---+---+---+---+   +---+---+---+---+---+   +   +---+---+   +   +
|   |       |                   |   |               |       |       |               |       |       |   |
|   |       |                   |   |               |       |       |               |       |       |   |
|   |       |                   |   |               |       |       |               |       |       |   |
+   +---+   +   +---+---+---+   +   +   +   +---+   +   +---+   +   +   +   +---+   +---+   +   +   +   +
|   |       |       |                       |               |   |       |       |   |       |   |   |   |
|   |       |       |                       |               |   |       |       |   |       |   |   |   |
|   |       |       |                       |               |   |       |       |   |       |   |   |   |
+   +   +---+---+   +   +   +   +   +   +   +---+---+---+   +   +---+---+   +   +---+   +   +---+   +   +
|   |       |       |   |   |   |   |   |       |           |           |   |           |           |   |
|   |       |       |   |   |   |   |   |       |           |           |   |           |           |   |
|   |       |       |   |   |   |   |   |       |           |           |   |           |           |   |
+   +---+   +   +---+   +   +---+   +   +   +   +   +---+   +   +---+   +   +---+---+---+---+---+---+   +
|       |       |       |           |       |       |       |                                            
|       |       |       |           |       |       |       |                                            
|       |       |       |           |       |       |       |                                            
+---+---+---+---+---+---+---+---+---+---+---+---+---+---+---+---+---+---+---+---+---+---+---+---+---+---+